#######
#..#..#
##...##
#..#..#
#.###.#
#...#.#
#######
A
